Inv_j	Viridiplantae;.Streptophyta;.Streptophytina;.Embryophyta;.Tracheophyta;.Euphyllophyta;.Spermatophyta;.Magnoliopsida;.Mesangiospermae;.eudicotyledons;.Gunneridae;.Pentapetalae;.asterids;.campanulids;.Asterales;.Asteraceae;.Asteroideae;.Astereae;.North American clade;.Symphyotrichum;.Symphyotrichum subulatum
Native1	Viridiplantae;.Streptophyta;.Streptophytina;.Embryophyta;.Tracheophyta;.Euphyllophyta;.Spermatophyta;.Magnoliopsida;.Mesangiospermae;.eudicotyledons;.Gunneridae;.Pentapetalae;.asterids;.campanulids;.Asterales;.Asteraceae;.Asteroideae;.Anthemideae;.Artemisiinae;.Artemisia;.Artemisia stolonifera
Native10	Viridiplantae;.Streptophyta;.Streptophytina;.Embryophyta;.Tracheophyta;.Euphyllophyta;.Spermatophyta;.Magnoliopsida;.Mesangiospermae;.eudicotyledons;.Gunneridae;.Pentapetalae;.Caryophyllales;.Polygonaceae;.Polygonoideae;.Persicarieae;.Persicaria;.Persicaria chinensis
Native11	Viridiplantae;.Streptophyta;.Streptophytina;.Embryophyta;.Tracheophyta;.Euphyllophyta;.Spermatophyta;.Magnoliopsida;.Mesangiospermae;.eudicotyledons;.Gunneridae;.Pentapetalae;.Caryophyllales;.Polygonaceae;.Polygonoideae;.Persicarieae;.Persicaria;.Persicaria filiformis
Native12	Viridiplantae;.Streptophyta;.Streptophytina;.Embryophyta;.Tracheophyta;.Euphyllophyta;.Spermatophyta;.Magnoliopsida;.Mesangiospermae;.eudicotyledons;.Gunneridae;.Pentapetalae;.Caryophyllales;.Polygonaceae;.Polygonoideae;.Persicarieae;.Persicaria;.Persicaria lapathifolia
Native13	Viridiplantae;.Streptophyta;.Streptophytina;.Embryophyta;.Tracheophyta;.Euphyllophyta;.Spermatophyta;.Magnoliopsida;.Mesangiospermae;.eudicotyledons;.Gunneridae;.Pentapetalae;.rosids;.fabids;.Fabales;.Fabaceae;.Papilionoideae;.50 kb inversion clade;.NPAAA clade;.Hologalegina;.IRL clade;.Galegeae;.Astragalus;.Astragalus sinicus
Native14	Viridiplantae;.Streptophyta;.Streptophytina;.Embryophyta;.Tracheophyta;.Euphyllophyta;.Spermatophyta;.Magnoliopsida;.Mesangiospermae;.eudicotyledons;.Gunneridae;.Pentapetalae;.rosids;.fabids;.Fabales;.Fabaceae;.Papilionoideae;.50 kb inversion clade;.NPAAA clade;.Hologalegina;.robinioid clade;.Sesbanieae;.Sesbania;.Sesbania cannabina
Native15	Viridiplantae;.Streptophyta;.Streptophytina;.Embryophyta;.Tracheophyta;.Euphyllophyta;.Spermatophyta;.Magnoliopsida;.Mesangiospermae;.eudicotyledons;.Gunneridae;.Pentapetalae;.Saxifragales;.Penthoraceae;.Penthorum;.Penthorum chinense
Native16	Viridiplantae;.Streptophyta;.Streptophytina;.Embryophyta;.Tracheophyta;.Euphyllophyta;.Spermatophyta;.Magnoliopsida;.Mesangiospermae;.Liliopsida;.Petrosaviidae;.commelinids;.Poales;.Poaceae;.BOP clade;.Pooideae;.Poodae;.Poeae;.Loliinae;.Lolium;.Lolium perenne
Native2	Viridiplantae;.Streptophyta;.Streptophytina;.Embryophyta;.Tracheophyta;.Euphyllophyta;.Spermatophyta;.Magnoliopsida;.Mesangiospermae;.eudicotyledons;.Gunneridae;.Pentapetalae;.asterids;.campanulids;.Asterales;.Asteraceae;.Asteroideae;.Heliantheae alliance;.Coreopsideae;.Bidens;.Bidens pilosa
Native3	Viridiplantae;.Streptophyta;.Streptophytina;.Embryophyta;.Tracheophyta;.Euphyllophyta;.Spermatophyta;.Magnoliopsida;.Mesangiospermae;.eudicotyledons;.Gunneridae;.Pentapetalae;.asterids;.campanulids;.Asterales;.Asteraceae;.Asteroideae;.Heliantheae alliance;.Heliantheae;.Eclipta;.Eclipta prostrata
Native4	Viridiplantae;.Streptophyta;.Streptophytina;.Embryophyta;.Tracheophyta;.Euphyllophyta;.Spermatophyta;.Magnoliopsida;.Mesangiospermae;.eudicotyledons;.Gunneridae;.Pentapetalae;.asterids;.campanulids;.Asterales;.Asteraceae;.Cichorioideae;.Cichorieae;.Cichoriinae;.Cichorium;.Cichorium intybus
Native5	Viridiplantae;.Streptophyta;.Streptophytina;.Embryophyta;.Tracheophyta;.Euphyllophyta;.Spermatophyta;.Magnoliopsida;.Mesangiospermae;.eudicotyledons;.Gunneridae;.Pentapetalae;.asterids;.campanulids;.Dipsacales;.Caprifoliaceae;.Patrinia;.Patrinia scabiosifolia
Native6	Viridiplantae;.Streptophyta;.Streptophytina;.Embryophyta;.Tracheophyta;.Euphyllophyta;.Spermatophyta;.Magnoliopsida;.Mesangiospermae;.eudicotyledons;.Gunneridae;.Pentapetalae;.asterids;.lamiids;.Lamiales;.Acanthaceae;.Acanthoideae;.Justicieae;.Justicia;.Justicia adhatoda
Native7	Viridiplantae;.Streptophyta;.Streptophytina;.Embryophyta;.Tracheophyta;.Euphyllophyta;.Spermatophyta;.Magnoliopsida;.Mesangiospermae;.eudicotyledons;.Gunneridae;.Pentapetalae;.asterids;.lamiids;.Lamiales;.Lamiaceae;.Nepetoideae;.Elsholtzieae;.Perilla;.Perilla frutescens
Invasion	Viridiplantae;.Streptophyta;.Streptophytina;.Embryophyta;.Tracheophyta;.Euphyllophyta;.Spermatophyta;.Magnoliopsida;.Mesangiospermae;.eudicotyledons;.Gunneridae;.Pentapetalae;.asterids;.campanulids;.Asterales;.Asteraceae;.Asteroideae;.Astereae;.North American clade;.Solidago;.Solidago canadensis
Plant1	Viridiplantae;.Streptophyta;.Streptophytina;.Embryophyta;.Tracheophyta;.Euphyllophyta;.Spermatophyta;.Magnoliopsida;.Mesangiospermae;.eudicotyledons;.Gunneridae;.Pentapetalae;.asterids;.lamiids;.Lamiales;.Acanthaceae;.Acanthoideae;.Justicieae;.Justicia;Justicia procumbens
Plant2	Viridiplantae;.Streptophyta;.Streptophytina;.Embryophyta;.Tracheophyta;.Euphyllophyta;.Spermatophyta;.Magnoliopsida;.Mesangiospermae;.eudicotyledons;.Gunneridae;.Pentapetalae;.asterids;.lamiids;.Lamiales;.Lamiaceae;.Nepetoideae;.Elsholtzieae;.Mosla;.Mosla hangchowensis
Plant3	Viridiplantae;.Streptophyta;.Streptophytina;.Embryophyta;.Tracheophyta;.Euphyllophyta;.Spermatophyta;.Magnoliopsida;.Mesangiospermae;.eudicotyledons;.Gunneridae;.Pentapetalae;.asterids;.lamiids;.Lamiales;.Plantaginaceae;.Plantagineae;.Plantago;.Plantago asiatica
Plant4	Viridiplantae;.Streptophyta;.Streptophytina;.Embryophyta;.Tracheophyta;.Euphyllophyta;.Spermatophyta;.Magnoliopsida;.Mesangiospermae;.eudicotyledons;.Gunneridae;.Pentapetalae;.asterids;.lamiids;.Solanales;.Solanaceae;.Solanoideae;.Solaneae;.Solanum;.Solanum nigrum
Plant5	Viridiplantae;.Streptophyta;.Streptophytina;.Embryophyta;.Tracheophyta;.Euphyllophyta;.Spermatophyta;.Magnoliopsida;.Mesangiospermae;.eudicotyledons;.Gunneridae;.Pentapetalae;.Caryophyllales;.Amaranthaceae;.Achyranthes;.Achyranthes bidentata
Plant6	Viridiplantae;.Streptophyta;.Streptophytina;.Embryophyta;.Tracheophyta;.Euphyllophyta;.Spermatophyta;.Magnoliopsida;.Mesangiospermae;.eudicotyledons;.Gunneridae;.Pentapetalae;.Caryophyllales;.Polygonaceae;.Polygonoideae;.Persicarieae;.Persicaria;.Persicaria lapathifolia
Plant7	Viridiplantae;.Streptophyta;.Streptophytina;.Embryophyta;.Tracheophyta;.Euphyllophyta;.Spermatophyta;.Magnoliopsida;.Mesangiospermae;.eudicotyledons;.Gunneridae;.Pentapetalae;.rosids;.fabids;.Malpighiales;.Euphorbiaceae;.Acalyphoideae;.Acalypheae;.Acalypha;.Acalypha australis
Plant8	Viridiplantae;.Streptophyta;.Streptophytina;.Embryophyta;.Tracheophyta;.Euphyllophyta;.Spermatophyta;.Magnoliopsida;.Mesangiospermae;.eudicotyledons;.Gunneridae;.Pentapetalae;.rosids;.malvids;.Malvales;.Malvaceae;.Tilioideae;.Corchoropsis;.Corchoropsis tomentosa
Plant9	Viridiplantae;.Streptophyta;.Streptophytina;.Embryophyta;.Tracheophyta;.Euphyllophyta;.Spermatophyta;.Magnoliopsida;.Mesangiospermae;.Liliopsida;.Petrosaviidae;.commelinids;.Poales;.Poaceae;.PACMAD clade;.Panicoideae;.Andropogonodae;.Andropogoneae;.Arthraxoninae;.Arthraxon;.Arthraxon hispidus
outgroup1	Viridiplantae;.Streptophyta;.Streptophytina;.Embryophyta;.Tracheophyta;.Euphyllophyta;.Spermatophyta;.Acrogymnospermae;.Pinopsida;.Pinidae;.Cupressales;.Cupressaceae;.Sequoiadendron;.Sequoiadendron giganteum
outgroup2	Viridiplantae;.Streptophyta;.Streptophytina;.Embryophyta;.Tracheophyta;.Euphyllophyta;.Polypodiopsida;.Polypodiidae;.Polypodiales;.Aspleniineae;.Aspleniaceae;.Asplenium