matK	matK
rbcL	rbcL
ndhA	ndhA
ndhB	ndhB
ndhC	ndhC
ndhE	ndhE
ndhF	ndhF
ccsA	ccsA
atpH	atpH
atpF	atpF
atpB	atpB
ndhG	ndhG
ndhH	ndhH
ndhI	ndhI
petA	petA
petB	petB
petD	petD
petL	petL
psbA	psbA
psbK	psbK
rpl2	rpl2
rpl32	rpl32
rpoA	rpoA
rpoB	rpoB
rpoC1	rpoC1
